
    #####
    #   #
    #$  #
  ###  $##
  #    $ #
### # ## #   #####
#   # ## #####  .#
# $            ..#
##### ### #@##  .#
    #     ########
    #######

############
#..  #     ###
#..  # $  $  #
#..  #$####  #
#..    @ ##$ #
#..  # #  $ ##
###### ##$ $ #
  # $  $ $ $ #
  #    #     #
  ############
