    #####
    #   #
    #$  #
  ###  $##
  #    $ #
### # ## #   #####
#   # ## #####  .#
# $            ..#
##### ### #@##  .#
    #     ########
    #######
